//MAP CONVERTED BY dmm2tgm.py THIS HEADER COMMENT PREVENTS RECONVERSION, DO NOT REMOVE
"a" = (
/obj/structure/rack,
/obj/structure/sign/poster/official/random{
	pixel_x = 32
	},
/obj/effect/spawner/lootdrop/maintenance,
/turf/open/floor/plasteel/dark,
/area/clerk)
"b" = (
/obj/structure/rack,
/obj/item/toy/plush/beeplushie,
/turf/open/floor/plasteel/dark,
/area/clerk)
"c" = (
/obj/machinery/door/window/southleft{
	req_access_txt = "36"
	},
/obj/machinery/door/firedoor/border_only{
	dir = 1
	},
/obj/machinery/door/poddoor/shutters{
	id = "giftshop"
	},
/obj/machinery/atmospherics/pipe/simple/supply/hidden/layer2,
/obj/machinery/atmospherics/pipe/simple/scrubbers/hidden/layer4,
/turf/open/floor/plasteel,
/area/clerk)
"d" = (
/obj/structure/chair,
/obj/machinery/atmospherics/pipe/simple/supply/hidden/layer2{
	dir = 9
	},
/obj/machinery/atmospherics/pipe/simple/scrubbers/hidden/layer4{
	dir = 9
	},
/turf/open/floor/wood,
/area/clerk)
"e" = (
/obj/structure/sign/poster/contraband/random{
	pixel_x = -32
	},
/obj/machinery/light{
	dir = 8
	},
/obj/machinery/atmospherics/pipe/simple/supply/hidden/layer2{
	dir = 5
	},
/obj/machinery/atmospherics/pipe/simple/scrubbers/hidden/layer4{
	dir = 5
	},
/turf/open/floor/plasteel{
	icon_state = "redyellowfull"
	},
/area/clerk)
"f" = (
/obj/machinery/button/door{
	id = "giftshop";
	name = "Gift Shop Internal Shutters";
	pixel_x = 26;
	pixel_y = 24
	},
/obj/machinery/button/door{
	id = "giftshop_ext";
	name = "Gift Shop External Shutters";
	pixel_x = 40;
	pixel_y = 24
	},
/obj/structure/cable{
	icon_state = "1-8"
	},
/obj/machinery/atmospherics/pipe/manifold4w/supply/hidden/layer2,
/obj/machinery/atmospherics/pipe/manifold/scrubbers/hidden/layer4{
	dir = 8
	},
/turf/open/floor/wood,
/area/clerk)
"g" = (
/obj/machinery/atmospherics/components/unary/vent_scrubber/on/layer4{
	dir = 1
	},
/turf/open/floor/wood,
/area/clerk)
"h" = (
/obj/machinery/light{
	dir = 4
	},
/turf/open/floor/plasteel{
	icon_state = "redyellowfull"
	},
/area/clerk)
"i" = (
/obj/machinery/atmospherics/pipe/simple/scrubbers/hidden/layer4{
	dir = 4
	},
/turf/open/floor/plasteel{
	icon_state = "redyellowfull"
	},
/area/clerk)
"j" = (
/obj/machinery/atmospherics/pipe/manifold/scrubbers/hidden/layer4{
	dir = 1
	},
/obj/machinery/atmospherics/pipe/simple/supply/hidden/layer2{
	dir = 4
	},
/turf/open/floor/wood,
/area/clerk)
"k" = (
/obj/machinery/vending/gifts,
/obj/structure/sign/poster/official/random{
	pixel_y = 32
	},
/turf/open/floor/plasteel/dark,
/area/clerk)
"l" = (
/obj/effect/spawner/structure/window/reinforced,
/obj/machinery/door/poddoor/shutters/preopen{
	id = "giftshop_ext"
	},
/turf/open/floor/plating,
/area/clerk)
"m" = (
/obj/structure/rack,
/obj/effect/spawner/lootdrop/gloves,
/turf/open/floor/plasteel/dark,
/area/clerk)
"n" = (
/obj/structure/table,
/obj/item/toy/figure/clerk,
/obj/item/stack/sheet/cardboard{
	pixel_x = 2;
	pixel_y = 1
	},
/obj/item/stack/wrapping_paper{
	pixel_x = 3;
	pixel_y = 8
	},
/obj/item/stack/packageWrap{
	pixel_x = 1;
	pixel_y = 1
	},
/obj/item/hand_labeler{
	pixel_x = 8;
	pixel_y = -7
	},
/turf/open/floor/plasteel/dark,
/area/clerk)
"o" = (
/turf/template_noop,
/area/template_noop)
"p" = (
/obj/structure/table/wood,
/obj/item/poster/random_contraband{
	pixel_y = 2
	},
/obj/item/poster/random_official{
	pixel_x = 1;
	pixel_y = 5
	},
/obj/item/poster/random_official{
	pixel_x = 2;
	pixel_y = 8
	},
/obj/machinery/power/apc{
	areastring = "/area/clerk";
	dir = 1;
	name = "Gift Shop APC";
	pixel_y = 23
	},
/obj/structure/extinguisher_cabinet{
	pixel_x = -27
	},
/obj/structure/cable{
	icon_state = "0-4"
	},
/obj/machinery/atmospherics/components/unary/vent_pump/on/layer2{
	dir = 4
	},
/turf/open/floor/wood,
/area/clerk)
"r" = (
/obj/machinery/atmospherics/components/unary/vent_pump/on/layer2,
/turf/open/floor/plasteel{
	icon_state = "redyellowfull"
	},
/area/clerk)
"s" = (
/obj/structure/rack,
/obj/effect/spawner/lootdrop/costume,
/obj/machinery/camera{
	c_tag = "Clerk's office";
	dir = 8
	},
/turf/open/floor/plasteel/dark,
/area/clerk)
"t" = (
/obj/machinery/door/poddoor/shutters{
	id = "giftshop"
	},
/obj/machinery/door/firedoor/border_only{
	dir = 1
	},
/obj/structure/table/reinforced,
/turf/open/floor/plasteel,
/area/clerk)
"v" = (
/obj/structure/rack,
/obj/item/book/random,
/turf/open/floor/plasteel/dark,
/area/clerk)
"w" = (
/obj/machinery/vending/autodrobe,
/obj/machinery/light{
	dir = 4
	},
/turf/open/floor/plasteel/dark,
/area/clerk)
"x" = (
/obj/structure/rack,
/obj/item/a_gift,
/turf/open/floor/plasteel/dark,
/area/clerk)
"y" = (
/obj/effect/landmark/event_spawn,
/obj/item/storage/secure/safe{
	pixel_x = 35;
	pixel_y = 5
	},
/obj/machinery/atmospherics/components/unary/vent_scrubber/on/layer4{
	dir = 8
	},
/turf/open/floor/plasteel/dark,
/area/clerk)
"z" = (
/turf/open/floor/plasteel{
	icon_state = "redyellowfull"
	},
/area/clerk)
"A" = (
/obj/machinery/door/airlock{
	name = "Gift Shop";
	req_access_txt = "36"
	},
/obj/machinery/door/firedoor/border_only{
	dir = 8
	},
/obj/machinery/door/firedoor/border_only{
	dir = 4
	},
/obj/machinery/atmospherics/pipe/simple/scrubbers/hidden/layer4{
	dir = 4
	},
/obj/machinery/atmospherics/pipe/simple/supply/hidden/layer2{
	dir = 4
	},
/turf/open/floor/plasteel/dark,
/area/clerk)
"B" = (
/obj/machinery/firealarm{
	dir = 4;
	pixel_x = -26
	},
/obj/machinery/atmospherics/pipe/simple/supply/hidden/layer2{
	dir = 6
	},
/obj/machinery/atmospherics/pipe/simple/scrubbers/hidden/layer4{
	dir = 6
	},
/turf/open/floor/wood,
/area/clerk)
"C" = (
/obj/item/instrument/piano_synth{
	pixel_x = -10
	},
/obj/structure/table/wood,
/obj/machinery/light{
	dir = 1
	},
/obj/machinery/newscaster{
	pixel_y = 32
	},
/obj/item/instrument/guitar{
	pixel_x = 5;
	pixel_y = -1
	},
/obj/structure/cable{
	icon_state = "4-8"
	},
/obj/machinery/atmospherics/pipe/simple/supply/hidden/layer2{
	dir = 4
	},
/turf/open/floor/wood,
/area/clerk)
"D" = (
/obj/structure/rack,
/obj/machinery/airalarm{
	pixel_y = 24
	},
/obj/effect/spawner/lootdrop/maintenance,
/turf/open/floor/plasteel/dark,
/area/clerk)
"E" = (
/obj/machinery/door/firedoor/border_only{
	dir = 1
	},
/obj/machinery/door/poddoor/shutters{
	id = "giftshop"
	},
/obj/structure/table/reinforced,
/turf/open/floor/plasteel,
/area/clerk)
"F" = (
/obj/machinery/atmospherics/pipe/simple/scrubbers/hidden/layer4{
	dir = 4
	},
/mob/living/simple_animal/spiffles,
/turf/open/floor/plasteel/dark,
/area/clerk)
"G" = (
/obj/structure/rack,
/obj/effect/spawner/lootdrop/maintenance,
/turf/open/floor/plasteel/dark,
/area/clerk)
"H" = (
/obj/structure/rack,
/obj/effect/spawner/lootdrop/glowstick,
/obj/structure/sign/poster/official/random{
	pixel_y = 32
	},
/turf/open/floor/plasteel/dark,
/area/clerk)
"J" = (
/obj/machinery/atmospherics/pipe/simple/scrubbers/hidden/layer4{
	dir = 4
	},
/obj/machinery/atmospherics/pipe/simple/supply/hidden/layer2{
	dir = 10
	},
/turf/open/floor/plasteel/dark,
/area/clerk)
"L" = (
/obj/machinery/door/airlock/glass_large{
	doorOpen = 'sound/machines/defib_success.ogg';
	name = "Gift Shop"
	},
/obj/machinery/door/firedoor/border_only,
/obj/machinery/door/firedoor/border_only{
	dir = 1
	},
/obj/machinery/door/poddoor/shutters/preopen{
	id = "giftshop_ext"
	},
/turf/open/floor/plasteel/dark,
/area/clerk)
"M" = (
/obj/machinery/vending/games,
/obj/machinery/airalarm{
	pixel_y = 24
	},
/turf/open/floor/plasteel/dark,
/area/clerk)
"N" = (
/obj/structure/table,
/obj/item/clothing/under/yogs/rank/clerk/skirt{
	pixel_x = 2;
	pixel_y = -2
	},
/obj/item/storage/fancy/donut_box{
	pixel_x = -2;
	pixel_y = 10
	},
/obj/item/toy/crayon/spraycan{
	pixel_x = 16;
	pixel_y = 4
	},
/turf/open/floor/plasteel/dark,
/area/clerk)
"O" = (
/obj/machinery/door/firedoor/border_only,
/obj/machinery/door/firedoor/border_only{
	dir = 1
	},
/obj/machinery/door/poddoor/shutters/preopen{
	id = "giftshop_ext"
	},
/turf/open/floor/plasteel/dark,
/area/clerk)
"Q" = (
/obj/machinery/door/airlock{
	name = "Gift Shop";
	req_access_txt = "36"
	},
/obj/machinery/door/firedoor/border_only,
/obj/machinery/door/firedoor/border_only{
	dir = 1
	},
/obj/machinery/atmospherics/pipe/simple/scrubbers/hidden/layer4,
/obj/machinery/atmospherics/pipe/simple/supply/hidden/layer2,
/obj/structure/cable{
	icon_state = "1-2"
	},
/turf/open/floor/plasteel/dark,
/area/clerk)
"R" = (
/obj/machinery/paystand/register{
	dir = 1
	},
/obj/machinery/door/firedoor/border_only{
	dir = 1
	},
/obj/machinery/door/poddoor/shutters{
	id = "giftshop"
	},
/obj/structure/table/reinforced,
/turf/open/floor/plasteel,
/area/clerk)
"S" = (
/obj/machinery/atmospherics/pipe/simple/supply/hidden/layer2{
	dir = 4
	},
/obj/machinery/atmospherics/pipe/simple/scrubbers/hidden/layer4{
	dir = 4
	},
/turf/open/floor/wood,
/area/clerk)
"T" = (
/obj/machinery/atmospherics/pipe/simple/supply/hidden/layer2{
	dir = 9
	},
/obj/machinery/atmospherics/pipe/simple/scrubbers/hidden/layer4{
	dir = 4
	},
/turf/open/floor/plasteel{
	icon_state = "redyellowfull"
	},
/area/clerk)
"U" = (
/obj/machinery/atmospherics/pipe/simple/supply/hidden/layer2,
/obj/machinery/atmospherics/pipe/simple/scrubbers/hidden/layer4,
/turf/open/floor/plasteel{
	icon_state = "redyellowfull"
	},
/area/clerk)
"V" = (
/obj/structure/table,
/obj/item/storage/fancy/heart_box{
	pixel_x = 15;
	pixel_y = -1
	},
/obj/item/a_gift,
/obj/item/a_gift,
/obj/item/a_gift,
/obj/machinery/atmospherics/components/unary/vent_pump/on/layer2{
	dir = 1
	},
/turf/open/floor/plasteel/dark,
/area/clerk)
"W" = (
/obj/structure/rack,
/obj/machinery/light{
	dir = 1
	},
/turf/open/floor/plasteel/dark,
/area/clerk)
"X" = (
/obj/machinery/atmospherics/components/unary/vent_scrubber/on/layer4{
	dir = 8
	},
/turf/open/floor/plasteel{
	icon_state = "redyellowfull"
	},
/area/clerk)
"Y" = (
/turf/closed/wall,
/area/clerk)

(1,1,1) = {"
o
Y
Y
Y
Y
Y
Y
Y
Y
"}
(2,1,1) = {"
o
Y
p
B
c
U
e
x
l
"}
(3,1,1) = {"
o
Y
C
S
t
r
T
v
l
"}
(4,1,1) = {"
o
Q
f
d
R
z
i
G
l
"}
(5,1,1) = {"
o
Y
j
g
E
z
i
z
L
"}
(6,1,1) = {"
Y
Y
A
Y
Y
W
i
z
O
"}
(7,1,1) = {"
Y
k
J
V
Y
H
i
m
l
"}
(8,1,1) = {"
Y
M
F
N
Y
D
X
b
Y
"}
(9,1,1) = {"
Y
w
y
n
Y
s
h
a
Y
"}
(10,1,1) = {"
Y
Y
Y
Y
Y
Y
Y
Y
Y
"}
